NO ./textures/wall1.xpm
SO ./textures/wall2.xpm
WE ./textures/wall3.xpm
EA ./textures/wall4.xpm

F 50,86,168
C 50,168,139

11111
10S11
10011
10011
10011
10011
10011
11111