NO ./assets/wall_no.xpm
SO ./assets/wall_so.xpm
WE ./assets/wall_we.xpm
EA ./assets/wall_ea.xpm
F 18,70,33
C 17,250,255




111111111111111111111111
101N0010010100001111
111100011101111111111111111
1000000000111111111111111
10000000000000111111
10000000000011111
1011111111111111111
101111111
1111111111111
1011111
1111111111111111111111111









