NO ./textures/wall1.xpm
SO ./textures/wall2.xpm
WE ./textures/wall3.xpm
EA ./textures/wall4.xpm

F 50,86,168
C 50,168,139

1111111111
1000000001
1001000001
1000100001
1000100001
1000100001
1000100001
1000100001
1000W00001
1111111111
