
NO ./textures/wall1.xpm
SO ./textures/wall2.xpm

            11111111111111111111111111111111111111
            10000001000001011100001011000000100001
            10010110010100100010010100110100100111
            11001010100101011001010100101001000011
            10000001010111010000000100101010000001
            10000000011110010010101001001000011111
            10000000000111010010100100101010100011
            100010101001010010101000100101S1001001
11111111111111111111111111111111111111000000000001
10000000000000000000000000000000000000011111111111
10000000000000000000000000000000000000001111111111
10111111111111111111101111111111111011111
101                 100001        101
101                 100001        101
101                 100001        101
101                 100001        101
101                 100001        101
101                 100001        101
101                 100001        101
101                 100001        101
101                 100001        101
101                 100001        101
101                 100001        101
101                 100001        101
101                 100001        101
101111111111111111111111011111111110111111111
1000000000000000000000000000000000000000001
11111111111111111111111111111111111111111111

WE ./textures/wall3.xpm
EA ./textures/wall4.xpm

F 50,86,168
C 50,168,139
